1C0  1WH  1WH  1WH  1WH  1WH  1WH  1WH  1WH  1WH  1WH  1WH  1WH  1WH  1WH  1WH  1WH  1WH  1C1
1WV  0    0    0    0    0    0    0    0    0    0    0    0    0    0    0    0    0    1WV
1WV  0    0    0    0    0    0    0    0    0    0    0    0    0    1PU  0    0    0    1WV
1WV  0    0    0    0    0    0    0    0    0    0    0    0    S    1WV  0    B    0    1WV
1WV  0    0    0    0    0    0    1PU  0    0    P    0    0    1PL  1TR  0    0    0    1WV
1WV  0    0    0    0    Y    0    1WV  0    0    1PU  0    0    0    1TL  1WH  1PR  0    1WV
1WV  0    0    1PU  0    0    0    1WV  0    0    1WV  0    0    0    1WV  0    0    0    1WV
1WV  0    0    1TL  1WH  1WH  1WH  1TD  1WH  1WH  1TD  1TU  1WH  1WH  1C2  0    1PL  1WH  1TR
1WV  0    0    1WV  0    0    0    0    0    0    0    1PD  0    0    0    G    0    0    1WV
1WV  0    J    1WV  2EU  2EU  2EU  0    0    0    0    0    0    1PU  0    0    0    0    1WV
1C3  1WH  1WH  1TD  2FU  2FU  2FU  1WH  1WH  1WH  1WH  1WH  1WH  1TD  1WH  1WH  1WH  1WH  1C2
