1111111111111111111
1000000000000000001
1000000000000000001
10000000G0000000001
1000000000000000001
100000B000Y00000001
1000000000000100001
1000000000100100001
1000000000000122221
1000000001JSP111111
1111111111111111111