1111111111111111111
1000000000000000001
1000000000000010001
1000000000000S10B01
1000000100P00110001
10000Y0100100011101
1001000100000010001
1001111111111110111
100100000010000G001
10J1222000000100001
1111111111111111111