1111111111111111111
10000S00J000S000001
1000000000000000001
1000000000000000001
10000G0000000000001
100000000B000000001
1001000001000100001
100000Y010000100001
1000000000000122221
10000P000S00J111111
1111111111111111111