1C0  1WH  1WH  1WH  1WH  1WH  1WH  1WH  1WH  1WH  1WH  1WH  1WH  1WH  1WH  1WH  1WH  1WH  1C1
1WV  SR   0    0    0    SD   0    SL   0    0    0    0    0    0    0    0    0    0    1WV
1WV  0    0    0    0    0    0    0    0    0    0    0    0    0    0    0    0    0    1WV
1WV  0    0    0    0    0    0    0    0    0    0    0    0    0    0    0    0    0    1WV
1WV  0    0    0    0    3AR  2AR  3AD  0    3CR  2CR  3CD  0    3ER  2ER  3ED  0    0    1WV
1WV  0    0    0    2AUM 2AU  0    2AD  0    2CU  0    2CD  0    2EU  0    2ED  0    0    1WV
1WV  0    0    0    3AUM 3AU  2AL  3AL  0    3CU  2CL  3CL  0    3EU  2EL  3EL  0    0    1WV
1WV  0    0    SU   0    0    0    0    0    0    JD   0    0    0    PD   0    0    0    1WV
1WV  0    0    0    0    0    0    0    0    0    0    0    0    0    0    0    0    0    1WV
1WV  0    0    0    0    0    0    0    JU   0    0    0    PU   0    0    0    0    0    1WV
1C3  1WH  1WH  1WH  1WH  1WH  1WH  1WH  1WH  1WH  1WH  1WH  1WH  1WH  1WH  1WH  1WH  1WH  1C2